NO textures/wolfenstein/grey_stone.xpm
WE textures/wolfenstein/red_brick.xpm
EA textures/wolfenstein/wood.xpm
C 91,97,100
SO textures/wolfenstein/grey_stone.xpm
F 33,35,1
111111
1000W1
100001
111111