NO textures/wolfenstein/grey_stone.xpm
WE textures/wolfenstein/red_brick.xpm
EA textures/rsz_1flag_of_palestine.xpm
SO textures/wolfenstein/red_brick.xpm
C 91,97,100
F 33,       35,0
1111111
100W001
1000011
 1111
