11111111111111111111111111111
1001N000000000000000000000001
10100000000000000000000000001
10100000000000000000000000001
10100000000000000000000000001
10100000000000000000000000001
10100000000000000000000000001
10000000000000000000000000001
10100000000000000000000000001
11000000000000000000000000001
11111111111111111111111111111