        1111111111111111111111111
        1000000000110000000000001
        1011000001110000000000001
        1001000111000000000000001
111111110011000001110000000000001
10N000000110000011111111111111111
11110111111111011100000010001
11100011  1111011110100000011
110000001101000001100000100011
100000000000000000000000000001
100000100000000010010010010011
110000111100010111110111100111
11110111 1110101 101111010001
11111111111111111111111111111