11111111111111111
1N110100000000001
10100000000000001
10100000000010001
10100111110010001
10100000000010001
10100000111110001
10000000100000001
10000000100000111
11000000000000111
11111111111111111