        1111111111111111111111111
        1000000000110000000000001
        1011000001110000000000001
        1001000111000000000000001
111111110011000001110000000000001
10000000011000001110111111111111
11110111111111011100000010001
11100011  1111011101010010001
110000001101000001100000010001
10000000000000100N000001000111
10000010000000000000101001001
11000001110001011111011110011
11110111 1110101 101111010001
11111111111111111111111111111